. . . . . .
. B B . # .
. . L . . .
. . . . . .
. # . B . .
. . . . . A
